NO ./sprites/trees.xpm
SO ./sprites/trees.xpm
WE ./sprites/trees.xpm
EA ./sprites/trees.xpm

F 170,250,190
C 100,180,250

11111111111111111111111111111
100000000000001100000000000011
101100000000001000000000000001
101100000000000000000000000001
101100000000000000000000000001
1001N0000000000000000000111111111
111100000011000001110000000000001
100000000011000001110111111111111
11110000001111011100000010001
11110000001111011101010010001
11000000000101011100000010001
10000000000000001100000010001
10000000000000001101010010001
110000011101010111111111100111
11110111 1110101 101011010001
11111111 1111111 111111111111