NO ./assets/hills.xpm
SO ./assets/hills.xpm
WE ./assets/hills.xpm
EA ./assets/hills.xpm

F 255, 149, 122
C 240, 242, 215

111           111
101           101
111           111

11111111111111111
10000000000000001
10000000000000001
10000000000000001
10000000000000001
10000000000000001
10000000000000001
10000000000000001
10000000N00000001
10000000000000001
10000000000000001
10000000000000001
10000000000000001
10000000000000001
10000000000000001
10000000000000001
11111111111111111

111           111
101           101
111           111