NO ./sprites/trees.xpm
SO ./sprites/trees.xpm
WE ./sprites/trees.xpm
EA ./sprites/trees.xpm

F 170,250,190
C 100,180,250

11111111
1N000001
10000001
10000001
10000001
10000011
11111111
