NO ./sprites/country.xpm
SO ./sprites/country.xpm
WE ./sprites/country.xpm
EA ./sprites/country.xpm

F 137, 181, 128
C 130, 182, 255

11111111111111111111111111111111
10000M0P000000110000000000110001
10110001000000110000000000110001
1011000000M000M000M0000000000001
101100000000M00M000M000000000001
1001000E00000000000000100000000111111
1111000000110000000000P0000000000001
1000000000110000000000110000011111111
1111000000P0000000000000000001111
111100000011110000000000000000001
100000000000000000000000000000001
100000000000000000000000000000111
100000000000000000000000000111111
100000011100000000000001111111111
10000001 111110000000001011010001
11111111 111111111111111111111111