NO ./assets/country.xpm
SO ./assets/country.xpm
WE ./assets/country.xpm
EA ./assets/country.xpm

F 137, 181, 128
C 130, 182, 255



1111111111111111111111111111111111111111111
1000000000000000000000M00000000M00000000001
10000M000000000000M000000000000000000000001
100000000000000000000000M000000000000000001
1000000011100011100000000000111111100000001
1000000010111110100000000001111011110000001
1000M00100000000010000E00011100000111000001
1000M00100100010010000000011000000011000001
1000000101P101P1010000000010010001001000001
10000001001000100100000000101P101P1010000011111111111111111111
100000010000000001000000001001000100100000P0000000000000000001
1000000P000000000010000000100001000010000011111111111111111101
10000001000000M011P000000010000000001000001                101
10000000100M0000001000000011001110011000001                1M1
100000000100000011000000001010000010100M001           11111101111111111
10000M0001111111000000000010011111001000001           10000000000000001
10000000000000000M0000000010000000001000001           10000000000M00001
1000000000000000000000000000000000000000001           10000110001100001
10000000M000000000000000000M000000000000001           10001001010010001
1000000000000000000000000000000000000000001           10001000100010001
11111111111111111000001111111111111111111111111111111 10000100000100001
                1000001                   10000000001 10000010001000001
                1000001                   10000000001 10000001010000001
                1000M01111111111111111111110000000001110000000100000001
                100000P000000000000000000000000000000P00000000000000001
                1000001111111111111111111110000000000110000M00000000001
                1000001                   1000000M000111111111111111111
                1111111                   100000000001      111
                                          111111001111      101
                                               1001         11
                                        1111111100111111111111111111
                                        1000000000000000000000000001
                                        1000100000000M00000000000001
                                        1001P10000000000000010000001
                                        10001000000000000001P1000001
                                        1000000000000000000010000001
                                        100000M000000000000000000001
                                        1000000000010000000000000001
                                        10000000001P100000000M000001
                                        1000000000010000000000000001
                                        1000000000000000000000000001
                                        1000000000M00000000000000001
                                        1000000000000001000M00000001
                                        100000000000001P100000000001
                                        1000010000000001000000010001
                                        10001P10000000000000001P1001
                                        1000010000000000000000010001
                                        1000000000000000000000000001
                                        1111111111111111111111111111