NO ./sprites/country.xpm
SO ./sprites/country.xpm
WE ./sprites/country.xpm
EA ./sprites/country.xpm

F 137, 181, 128
C 130, 182, 255

11111111111111111111111111111111
100000000000001100000000M0110001
101100M0000000110000000000110001
10110000000000000000000000000001
101100000000M0000000000000000001
1001E00000000000000000000000000111111
11110000001100000000001100M0000000001
1000000000110000000000110000011111111
111100000011110000000000000001111
111100000011110000000000000000001
100000000000000000000000000000001
100000000000000000000000000000111
10000000000000000000000M000111111
100000011100000000000001111111111
10000001 111110000000001011010001
11111111 111111111111111111111111