NO ./assets/country.xpm
SO ./assets/country.xpm
WE ./assets/country.xpm
EA ./assets/country.xpm

F 137, 181, 128
C 130, 182, 255

11111111111111111111111111111111
1000000P00000011000000M000110001
10110001000000110000000000110001
1011000000M000M000M0000000000001
101100000000M00M000M000000000001
1001000E00000000000000100000000111111
1111000000110000000000P0000000000001
1000000000110000000000110000011111111
1111000000P0000000000000000001111
111100000011110000000000000000001
1000000000000000000000000000000M1
100000000000000000000000000000111
1M0000000000000000000000000111111
100000011100000000000001111111111
10000001 11111000000M001011010001
11111111 111111111111111111111111