NO ./sprites/country.xpm
SO ./sprites/country.xpm
WE ./sprites/country.xpm
EA ./sprites/country.xpm

F 137, 181, 128
C 130, 182, 255

111111111111111111111111111111
100000000000001100000000000001
101100000000001000000000000001
101100000000000000000000000001
101100000000000000000000000001
1001E00000000000000000M0111111111
111100000011000001110000000000001
100000000011000001110111111111111
11110000001111011100000010001
11110000001111011101010010001
11000000000101011100000010001
10000000000000001100000010001
10000000000000001101010010001
11000001110101011111111110011
11110111 1110101 101011010001
11111111 1111111 111111111111